PLANE 49 38
#################################################
#####################*******#####################
#####################*******#####################
#####################*******#####################
#####################*******#####################
#####################*******#####################
#####################*******#####################
#####################*******#####################
#####################*******#####################
#####################*******#####################
#####################*******#####################
#####################*******#####################
#####################*******#####################
#####################*******#####################
#####################*******#####################
#####################^^^^^^^#####################
#*******************<       >*******************#
#*******************<   h   >*******************#
#*******************<   h   >*******************#
#*******************<   h   >*******************#
#*******************<   h   >*******************#
#*******************<       >*******************#
#####################vvvvvvv#####################
#####################*******#####################
#####################*******#####################
#####################*******#####################
#####################*******#####################
#####################*******#####################
#####################*******#####################
#####################*******#####################
#####################*******#####################
#####################*******#####################
#####################*******#####################
#####################*******#####################
#####################*******#####################
#####################*******#####################
#####################*******#####################
#################################################