TORUS 10 10
*        #
###   ####
#0    #1 0
##########
1        #
*   h    #
#        #
#      A #
##########
A         


