TORUS 20 10
####################
 P  >  e > *  >  * >
P   >  * > e  >  e >
 *  >  * > *  >  * >
P   >  * > *  >  * >
 *  > *  > e  >  e >
 *  >  * > *  >  * >
  P >  * > *  >  * >
 h  >  e > *  >  e >
####################
