TORUS 20 10
####################
 h  >  * > *  >  * >
*   >  * > e  >  e >
 *  >  * > *  >  P >
h   >  h > *  >  P >
 *  > *  > e  >  e >
 *  >  P > *  >  P >
  P >  * > *  >  P >
 h  >  * > *  >  e >
####################
