PLANE 20 11
####################
#         <   v<<10#
#   1     ^   v* >v#
#         ^   v>  v#
#   P     ^    *  v#
#         ^       v#
#   *     ^    *  v#
#         ^       v#
#*        ^      hv#
#0        ^    <<<<#
####################

