PLANE 20 20
####################
#P 0            6 P#
# 2      h       4 #
#1 3            5 0#
#                  #
#                  #
#                  #
#                  #
#       7 8        #
#   h    P    e    #
#       4 2        #
#                  #
#                  #
#                  #
#                  #
#                  #
#9 5            3 9#
# 8      e       7 #
#P 1            6 P#
####################
