TORUS 30 11
>>>>>>>>>>>>>>vPPPPPPPPP<1>>>>
>>>>>>>>>>>>>0vvvvvv2vvv<*>^>>
>>>>>>>>*>>>>>v<>>v>v<v>>>>^3>
<<<<<<<<<*<<<<vh3<1>>>>>>>>^>0
>>>>>v>>>>>^<<v<<<<<<<<<<<<^>>
>>>>>>>>>>>^<<v>>>>>>>>>>>>^>>
<<<<<<<<<<<<<<v>>>>v>>^<<<<^<<
>>>>>>>>>>>>>>>>>>>v>>^<<<<^>>
>>>>>>>>>>>>>>>>>>>v>>^<<<<^>>
<<<<<<<<<e<<<<<<<<<v<<^<<<2^<<
<<<<<<<<<<<<<<<<<<<v<<<<<<^<<<

