PLANE 20 10
####################
#   >  e > *  >    #
#   >    >    >    #
#*  >    >    >  * #
#   >    >    >    #
#*  > *  >    >    #
#*  >    >    >  * #
#   >    >    >    #
#h  >  e >    >    #
####################
