PLANE 75 25
###########################################################################
# ****************                    > > > > > > > > > ##>>> #>>>        #
# ****************                    > > > > > > > > ##>>> #>> ###########
# ****************                    > > > > > > > ##>>> #>> #>>>        #
# ****************                    > > > > > > ##>>> #>> #>> ###########
# ****************                    > > > > > ##>>> #>> #>> #>>>        #
# ****************                    > > > > ##>>> #>> #>> #>> ###########
# ****************                    > > > ##>>> #>> #>> #>> #>>>        #
# ****************                    > > ##>>> #>> #>> #>> #>> ###########
# ****************                    > ##>>> #>> #>> #>> #>> #>>>        #
# ****************                    ##>>> #>> #>> #>> #>> #>> ###########
# ****************h               ####>>> #>> #>> #>> #>> #>> #>>>        #
# ****************                >>>P> #>> #>> #>> #>> #>> #>> ###########
# ****************                ####>>> #>> #>> #>> #>> #>> #>>>        #
# ****************                    ##>>> #>> #>> #>> #>> #>> ###########
# ****************                    > ##>>> #>> #>> #>> #>> #>>>        #
# ****************                    > > ##>>> #>> #>> #>> #>> ###########
# ****************                    > > > ##>>> #>> #>> #>> #>>>        #
# ****************                    > > > > ##>>> #>> #>> #>> ###########
# ****************                    > > > > > ##>>> #>> #>> #>>>        #
# ****************                    > > > > > > ##>>> #>> #>> ###########
# ****************                    > > > > > > > ##>>> #>> #>>>        #
# ****************                    > > > > > > > > ##>>> #>> ###########
# ****************                    > > > > > > > > > ##>>> #>>>        #
###########################################################################