PLANE 10 10
h > ***** 
  > ***** 
  >vvvvvvv
  > *** < 
  > *** <*
**>^^vvv<*
**>  >**<*
**>^^^^^< 
**> *** < 
**> *** < 