PLANE 20 10
####################
# >*> >*> > > > > *#
# > > > > > > > > *#
# > > > > > >*> > *#
# > > > > > > > > *#
# > > > ### > > > *#
# > > > > > > >*> *#
# > > > > > > > > *#
#h> >*> > >*> > > *#
####################
