PLANE 15 15
###############
#      *      #
# A       B   #
###############
#             #
#   *         #
#        h    #
#             #
#  A          #
#             #
###############
#             #
#         B   #
#   *         #
###############
