PLANE 26 7
##########################
#                        #
#                        #
# *         e          h #
#                        #
##########################