PLANE 11 11
###########
#A > *    #
###########
#      h  #
#         #
#      A  #
#         #
#         #
#*        #
#  *      #
###########
